participant;emotie;angst;politiek;ouders;geloof;vakantie;hobby;sport;adres;werk
1;3;4;4;4;3;4;3;2;4;3
2;3;2;2;3;2;4;1;3;4;2
3;2;3;3;4;1;3;2;1;5;3
4;4;5;3;2;3;2;2;2;4;2
5;3;4;1;4;3;4;4;1;3;3
6;4;5;4;4;2;4;2;1;4;1
7;4;2;3;2;1;2;1;1;3;1
8;3;3;2;3;2;3;2;1;4;1
9;3;2;2;2;2;3;2;1;3;1
10;3;3;1;4;1;3;1;1;3;1
